SO ./textures/congelados_pixel.png
F 129,110,30
C 236,212,133
EA ./textures/drogueria_pixel.png
NO ./textures/fruteria_pixel.png
WE ./textures/pan_pixel.png


1111111111111111111111111111111111111111111111111
1000000000000200020000000000020000000000000000001
1010000000001110010001001000111011001100110000001
1010000000001 100100010010001 1011001100110000001
1010000000001 100100210010001 1011001100110000001
1020000000001 10012010010001 1011001100110000011
1110000000001 111100010111001 1011001100110100001
11100000000011100000000000001110000000000000000S1
1111111111111 111111111111111 111111111111111111