SO ./textures/Pink.png
F 50,100,30
C 225,30,0
EA ./textures/Pink.png
NO ./textures/Pink.png
WE ./textures/Pink.png

       111111 1111111111111111111
        1000010000110000000000001
        1011000001110000000000001    111
        1001000000000000000000001    101
111111111011000001110000000000001    111
100000000011000001110111111111111
11110111111111011100000010001
11110111111111011101010010001
11000000110101011100000010001
10000010100100001100000010001
10000000000000001101010010001
11000001110101011111011110N111
11110111 1110101 101111010001
11111111 1111111 111111111111
 
111
101
111