SO ./textures/Pink.png
F 67,33,163
C 225,30,30
EA ./textures/Pink.png
NO ./textures/Pink.png
WE ./textures/Pink.png


111111111111111111111
100000000000001000001
100001000N00001000001
100001000000001000001
100001000000001000001
100001111111111000001
100000000000000000001
111111111111111111111
