SO ./textures/Pink.png
F 67,33,163
C 225,30,30
EA ./textures/foton.png
NO ./textures/Pink.png
WE ./textures/foton.png


111111111111111111111
100000000000000000001
100001000000001000001
100001000000001000001
1000010000W0001000001
100001111111111000001
100000000000000000001
111111111111111111111
