SO ./textures/puerta_pixel.png
F 67,33,163
C 225,30,0
EA ./textures/drogueria_pixel.png
NO ./textures/fruteria_pixel.png
WE ./textures/pan_pixel.png


1111111111111111111111111111111111111111111111111
1000000000000000000000000000000000000000000000001
1010000000001100010011001000110011001100110000001
1010000000001100010011001000110011001100110000001
1010000000001100010011001000110011001100110000001
1000000000001100010011001000110011001100110000001
11100W0000000001110011011100110011001100110000001
1110000000000000000000000000000000000000000000001
1111111111111111111111111111111111111111111111111
